▓▓▓▓▓▓▓▓
▓▓····▓▓
▓·××···▓
▓·▓·≡≡≡▓
▓···▓♀×▓
▓▓▓▓▓▓▓▓