▓▓▓▓▓▓▓▓
▓··×··▓▓
▓·≡≡▓×·▓
▓·▓♀≡··▓
▓··×▓··▓
▓▓▓▓▓▓▓▓