▓▓▓▓▓▓▓▓
▓····▓▓▓
▓···××·▓
▓·≡≡≡♀·▓
▓··▓·×·▓
▓▓▓▓▓▓▓▓